█████████████████████████████
█           █               █
█  $        █               █
█           ████████        █
█       █                   █
█       █           B       █
█   H   █                   ►
█████████████████████████████