█████████████████████████████████████
█                                   █
█   $                               █
█                                   █
█        ████████████████           █
█       █                           █
█       █           B     ███████████
█   H   █                         $ █
████◄███████████████████████ ████████
█$$███                    $█ █   █  █
█                          █ █ █ █  █
█  ██████████████████████  █ █ █ █  █
█  █                       █ $ █ █  █
█  █ ███████████████████████████ █  █
♦  █                             █  █
█████████████████████████████████████